##....#....#
.#.#....0...
..#.#0....#.
..##...0....
....0....#..
.#...#A....#
...#..#.....
#....#.#....
..#.....A...
....#....A..
.#........#.
...#......##

##....#....#
.#.#....0...
..#.#0....#.
..##...0....
....0....#..
.#...#A....#
...#..#.....
#....#.#....
..#.....A...
....#....A..
.#........#.
...#......##

.#f..##...#.#..#....#####..8....#.####...........#
G##...#..#..#8..u..........##.#...##.#.....#....#.
.#.#....G..#p...##.#..#.#...##.####.........####..
#...#.d.....##..###.......#.n..........#....#.##.#
.#...##.#....#..##...#..#..#.###......#.....##..#.
.##.#.#..#.#.#...#.##........##.#..#.K......#.#...
...#.#.#...##.....F.#.8.n##.B.K.....#...#..#....#.
.#..b..###....8.#u...#.#.....##....#.....##.#.#.#.
#.#..##..#.#.#.F#p.##..#.B...#.........4.#..#5...#
##..f.#d.#U#........#....#.....#..##c#..#.#.#.#...
.##..###.#.U#.#..d#n#u#0....#.......#..#5.##..##.#
...Y..#.#..f#......#....#.##...##.....5......#..##
#.#.#...##...##.##.#.#....u#....d..###e...###.##4.
..F..#p...#...##..##v....#...n..#####.......#..##.
##.#s.#....#..###.0...#.......###..##....##.#..##.
..#US.s##..g#...#D#...#..#....#...##.##.#...4#..#.
#.##..wG##.#####.#.##..S##..##...#..#######.......
....#.#.###...#...#....####.#B..#..e#...#.#....##.
##..#.#.#w#.####.#.###..##.....#.##A.#####.#..##..
........#..##9w.g..####..##...#.##..####...4.....#
U.#..9.#g...##v###.#P#..#D.#.##f#K##.###......#...
#s..#....#...#.0#.9...#.#..pP.#....###.5...#..#..#
..9s#.#.#.#.#####..##.#P..##.#.##...##...#..#...##
.....#....#.#b##..#.#####.#.#.##0.#.#.A..2#.#.e..#
##..##.#...###..#.#.b#####V#.v..#.....##..........
##...#.7###.....B#..#.#.#.#####..##....A.#..#.##.#
#..#.##.#.##....#.D6.#.V.###q#..###...#....###...#
..#v..#.#.#..##.D.##.PV.#.#.#######.#..###........
....#.##.Y.##.##....#g.#####.####.....#..#..#e.#y.
###....SW...#..V.#7.###...#...#...#...#c.#..#...#.
#.#.#.#bY7#......####.#.##.##.#N...##...A#.#...#..
#......##.....#...#..q.N....#..##.y.#.#.#.##..#..#
......###..#..##.###...#N.#..#####c..####..#..#...
.#.##.##...#.##.#.#.#....#..#######.......###..##.
..#.#.##.C.#7.##.#..###.#.##...q##.###..2#..#.#...
#........#.##.#.....#......#N#..q...####.#..###..#
...W.#..#.C3.##Q#...........#..#a1#.##...#.y#...#.
.#....#W....#....#.#..##..#.##.3.##.#.2.###..#...#
.#.###..3..#...#....6...#.....#.#.1#...#..##...##.
....3.##..#.#..#.C.1..#........#.#..###.k#.#..##..
E.####..##..##.....#.....#..#...#..a##.#.c#...##..
.......##........#.#...#.......#.#..#.##.##..w.#.#
..S..####....#.#..#.#...#.Q#...#..###2.#...#k#....
......#...#......#..#.C#..#6##.##.#Q.##.#.ak###.#.
##..##........#......#.#.#.........####.###.##.##.
#...#.#.....##.##E....#........a1....#.#.###.y#.##
W..#.......E...#.....#.........##.....#.##.#...#.#
..#..#E..#...#...#6.#..#...#..Q.....#..#...##.###.
##..............#...#...#..k......#..#####...#..##
#..#.....#...#.......#..#.....#..#...#...##...#...